アルヴィース	阿尔维斯	school's name
デュオ	迪欧	name
デュランダル＝ファーネク	杜兰达尔·费尔内克 	name
デュランダル	杜兰达尔	name
ファーネク	费尔内克	name
シャルロッテ＝カミル＝ハーリンガム	夏洛特·卡密尔·哈林肯	name
シャルロッテ	夏洛特	name
カミル	卡密尔	name
ハーリンガム	哈林肯	name
シャル	夏洛	name
フローリアム＝ブロセリアンド	 弗罗莉亚姆·普罗瑟里安德	name
フローリアム	弗罗莉亚姆	name
ブロセリアンド 	普罗瑟里安德	name
ローラ	罗拉	name
アリス＝アリステル＝ファーネク	爱丽丝·爱丽丝提尔·法奈克	name
アリステル	爱丽丝提尔	name
アリス	爱丽丝	name
ファーネク	法奈克	name
グラニティアーナ＝クリスティア	古拉妮蒂安娜·克里丝蒂亚	name
グラニティアーナ	古拉妮蒂安娜	name
クリスティア	克里丝蒂亚	name
グラニテ	古拉妮蒂	name
ソフィアーシェ＝ラフォニット	索菲娅修·拉冯尼特	name
ソフィアーシェ	索菲娅修	name
ラフォニット	拉冯尼特	name
ソフィア	索菲娅	name
ディアナ＝セレンディル	戴安娜·塞兰迪尔	name
ディアナ	戴安娜	name
セレンディル	塞兰迪尔	name
ルルガノ＝ヤヌシェ＝エンフィヌス	name
ルルガノ	露露加诺	name
ヤヌシェ	杰纳斯	name
エンフィヌス	恩菲纳斯	name
エンフィ	恩菲	name
ルル	露露	name
エスタリオル＝アルク＝レヌスベルン	埃斯塔利奥鲁·阿鲁库·兰努斯贝伦	name
エスタリオル	埃斯塔利奥鲁	name
レヌスベルン	兰努斯贝伦	name
リオル	利奥鲁	name
アルク	阿鲁库	name
ジウスドラ＝ノア＝ウトナピシュティム	祖斯德拉·诺阿·乌塔那匹兹姆	name
ジウスドラ	祖斯德拉	name
ノア	诺阿	name
ウトナピシュティム	乌塔那匹兹姆	name
フランキシヌス	弗兰基努斯	name
スニーク	斯尼库	name
スニースクル＝ヴァレンティクス	斯尼斯库鲁·瓦伦蒂斯	name
スニースクル	斯尼斯库鲁	name
ヴァレンティクス	瓦伦蒂斯	name
ノルバン＝ネーブルステア	诺万斯·纳维鲁斯特	name
ノルバン	诺万斯	name
ネーブルステア	纳维鲁斯特	name
ネーブル	纳维鲁	name
ハイペリオン	亥佩利昂	name
モンテシーノス	蒙特西诺斯	name
ルヴィー	路易	name
エールフィン	精灵
エルフ	精灵
ブロセリアンド	布罗塞里	name
花の姫君	花之公主
古き民	古民
イカロス	伊卡洛斯
ウィズアニバーサリィー	魔法使纪念日
ウィズアニ	魔法使纪念日
ウィズ	魔法使